################################
#______________________________#
#______________________________#
#______________________________#
#______________________________#
#______________________________#
#__________________#_______#___#
#______________________________#
#______________________________#
####_____####______#___#####___#
#___________#______#___#___#___#
#______________________________#
#______________________________#
#______________________________#
#______________________________#
#___##______#__##__________#___#
#____#______#______________#___#
#____#______############___#___#
#______________________________#
#______________________________#
#______________________________#
################################
